1;1;6;1;1;1;1;5 2;1;5 2;1;5 2;1;5 2;1;1;1;1;1;1;1;
1;0;0;0;0;0;0;0;0;0;0;0;0;0;0;0;0;0;0;1;
1;0;0;0;0;0;0;0;0;0;0;0;0;0;0;0;0;0;0;2;
1;0;0;0;0;0;0;0;1;1;1;0;0;0;0;0;0;0;0;1;
4;0;0;0;0;0;0;0;1;1;1;0;0;0;0;0;0;0;0;2;
1;0;0;0;0;0;0;0;1;1;1;0;0;0;0;0;0;0;0;1;
4;0;0;0;0;0;0;0;1;1;1;0;0;0;0;0;0;0;0;1;
1;0;0;0;0;0;0;0;1;1;1;0;0;0;0;0;0;0;0;5;
4;0;0;0;0;0;0;0;1;1;1;0;0;0;0;0;0;0;0;1;
1;0;0;0;0;0;0;0;0;0;0;0;0;0;0;0;0;0;0;5;
4;0;0;0;0;0;0;0;0;0;0;0;0;0;0;0;0;0;0;1;
1;1;1;1;1;1;1;3;3;3;3;1;1;1;5;1;1;5;1;1;