1;1;1;1;1;1;1;1;1;1 2;1;1 2;1;1;1;1;1;1;1;1;1;
1;0;0;0;0;0;0;0;0;0;0;0;0;0;0;0;0;0;0;1;
1;0;0;0;0;0;0;0;0;0;0;0;0;0;0;0;0;0;0;2;
1;0;0;0;0;0;0;0;1;1;1;0;0;0;0;0;0;0;0;1;
4 1;0;0;0;0;0;0;0;1;1;1;0;0;0;0;0;0;0;0;2;
1;0;0;0;0;0;0;0;1;1;1;0;0;0;0;0;0;0;0;1;
4 2;0;0;10;0;0;0;0;1;1;1;0;0;0;10;0;0;0;0;1;
1;0;0;0;0;0;0;0;1;1;1;0;0;0;0;0;0;0;0;5;
4 3;0;0;0;0;0;0;0;1;1;1;0;0;0;0;0;0;0;0;1;
1;0;0;0;0;0;0;0;0;0;0;0;0;0;0;0;0;0;0;5;
4 4;0;0;0;0;0;0;0;0;0;0;0;0;0;0;0;0;0;0;1;
1;1;1;1;1;1;1;3;3;3;3;1;1;1;5;1;1;5;1;1;