# You can put comments in this file by starting a line with a hash (#)
# The first line of this file is the recipes of the game
0;1;
# The second line is the duration of the game and the time between new recipes in seconds
120;20;
# The following lines are the matrix of the game
1;1;1;1;1;7;1;1;1;1;1;1;1;1;1;1;1;1;1;1;1;
1;0;0;0;0;0;0;0;0;0;0;0;0;0;0;0;0;0;0;1;
1;0;0;0;0;0;0;0;0;0;0;0;0;0;0;0;0;0;0;2;
1;0;0;0;0;0;0;0;1;1;1;0;0;0;0;0;0;0;0;1;
4 1;0;0;0;0;0;0;0;1;1;1;0;0;0;0;0;0;0;0;2;
1;0;0;0;0;0;0;0;1;1;1;0;0;0;0;0;0;0;0;1;
4 3;0;0;10;0;0;0;0;1;1;1;0;0;0;10;0;0;0;0;1;
1;0;0;0;0;0;0;0;1;1;1;0;0;0;0;0;0;0;0;5 1;
4 4;0;0;0;0;0;0;0;1;1;1;0;0;0;0;0;0;0;0;1;
1;0;0;0;0;0;0;0;0;0;0;0;0;0;0;0;0;0;0;5 1;
4 6;0;0;0;0;0;0;0;0;0;0;0;0;0;0;0;0;0;0;1;
1;1;1;6;1;1;1;1;3;3;3;1;1;1;5;1;1;5;1;1;